UCB = "countries/Ucnbb.txt"
DEM = "countries/Diriadem.txt"
SBU = "countries/Siburland.txt"
FBU = "countries/SiburlandDem.txt"
TRB = "countries/Terbia.txt"
RTT = "countries/Troba.txt"
NMA = "countries/North Macar.txt"
YAN = "countries/Yanthalia.txt"
ZAM = "countries/Zamder.txt"
DIR = "countries/Diria.txt"
RGY = "countries/Repgy.txt"
IID = "countries/Duxempire.txt"
FSC = "countries/solodov.txt"
GKD = "countries/redsmoke.txt"
TRP = "countries/terra.txt"
NIB = "countries/Niberia.txt"
NBL = "countries/Nibilla.txt"
KAR = "countries/Kartilia.txt"
FIL = "countries/Fillrussia.txt"
EGR = "countries/Egrinda.txt"
SVE = "countries/Sverlopa.txt"
VRO = "countries/vroin.txt"
ELR = "countries/moonrep.txt"
MOF = "countries/monfua.txt"
EMF = "counties/East Monfua.txt"
SFL = "countries/Safflia.txt"
TOL = "countries/Tolchkograd.txt"
PIN = "countries/Pinka.txt"
SHE = "countries/Sheregia.txt"
BAE = "countries/Baensli.txt"
OIK = "countries/Oikbb.txt"
EIK = "countries/Eiklind.txt"
BRC = "countries/Berechtia.txt"
ZHO = "countries/Zhoktasan.txt"
ERI = "countries/Erisito.txt"
CUS = "countries/Cusar.txt"
OUS = "countries/Oustar.txt"
LOB = "countries/Lobesho.txt"
KER = "countries/Kerstan.txt"
KAN = "countries/Kancountry.txt"
CHE = "countries/Chespen.txt"
LON = "countries/Lonaritia.txt"
LIP = "countries/Linepek.txt"
KAS = "countries/Kaspa.txt"
IRI = "countries/Irisia.txt"
BOU = "countries/Bounferte.txt"
NER = "countries/Neria.txt"
KUL = "countries/Kulishtia.txt"
ORB = "countries/Orbistan.txt"
CHO = "countries/Choramta.txt"
ESS = "countries/Esseshia.txt"
KIM = "countries/Kima.txt"
KOL = "countries/Kolechia.txt"
KOI = "countries/Konirski.txt"
GOD = "countries/Godeyskoe.txt"
TOR = "countries/Toru-Essa.txt"
DON = "countries/Donat.txt"
DID = "countries/Didoria.txt"
SMA = "countries/south macar.txt"
DIN = "countries/Dineria.txt"
LIV = "countries/Livery.txt"
BAK = "countries/Bakli.txt"
ELN = "countries/Elnia.txt"
ESB = "countries/East Siburia.txt"
LCH = "countries/Lobuchino.txt"
SIN = "countries/Sinicino.txt"
KRA = "countries/Krasna Tobina.txt"
SKI = "countries/Sardba Kinor.txt"
MOA = "countries/Moadera.txt"
SBO = "countries/Seler-Bolansi.txt"
LBD = "countries/Lebdel.txt"
ZHE = "countries/Zhereminente.txt"
ARS = "countries/arstrotska.txt"
TIR = "countries/tirandia.txt"
NRA = "countries/nrachia.txt"
SRA = "countries/srachia.txt"
TRN = "countries/Tarnskaya.txt"
PAL = "countries/Palishtia.txt"
BAR = "countries/Bartetidi.txt"
SOU = "countries/Sousi.txt"
SDR = "countries/Sedar.txt"
BUP = "countries/Buptas.txt"
DOS = "countries/Dosat.txt"
NEV = "countries/Nevegridia.txt"
LGH = "countries/Laganh.txt"
KOU = "countries/Koulskaya.txt"
TOB = "countries/tobisland.txt"
SZE = "countries/severozeldia.txt"
TAL = "countries/talshik.txt"
PER = "countries/Perdany.txt"
FLR = "countries/Fillirand.txt"
KUR = "countries/Kurililand.txt"
ANR = "countries/Anraks.txt"
BPR = "countries/Bahansk.txt"
BLJ = "countries/Baljury.txt"
BER = "countries/Berlend.txt"
FER = "countries/Ferdy.txt"
NOV = "countries/Novadiria.txt"
KRS = "countries/Karnosgar.txt"
EDI = "countries/Eik Diria.txt"
ESD = "countries/South Eik Diria.txt"
SVT = "countries/Savatia.txt"
HLR = "countries/Hleria.txt"
KLU = "countries/Koulskaya.txt"
DNG = "countries/Dangary.txt"
GWA = "countries/Gwanchi.txt"
KYU = "countries/Kyuryu.txt"
ECE = "countries/Evar.txt"
YEO = "countries/Yeosong.txt"
SOL = "countries/Soloput.txt"
BSH = "countries/Barshria.txt"
LOD = "countries/Lodjung.txt"
ZOG = "countries/Zargong.txt"
KCE = "countries/Karcae.txt"
ZAZ = "countries/Zarc.txt"
UNC = "countries/Unciar.txt"
HOR = "countries/Horga.txt"
GAR = "countries/Garzah.txt"
SDI = "countries/dirsindikat.txt"
BHI = "countries/Bhima.txt"
KVU = "countries/Kuruva.txt"
TUB = "countries/Tubana.txt"
PAL = "countries/Palishtia.txt"
BAR = "countries/Bartetidi.txt"
SOU = "countries/Sousi.txt"
SDR = "countries/Sedar.txt"
BUP = "countries/Buptas.txt"
DOS = "countries/Dosat.txt"
NEV = "countries/Nevegridia.txt"
LGH = "countries/Laganh.txt"
TRN = "countries/Tarnskaya.txt"
NCU = "countries/Narabel UCB.txt"

ORB = "countries/Orbistan.txt"
KOL = "countries/Kolechia.txt"
DIN = "countries/Dineria.txt"
ARS = "countries/arstrotska.txt"
TIR = "countries/tirandia.txt"
PER = "countries/Perdany.txt"
FLR = "countries/Fillirand.txt"
MIN = "countries/Minderia.txt"
TRI = "countries/Trinadia.txt"
KOS = "countries/Kostyany.txt"
RAN = "countries/Rangland.txt"
NIK = "countries/Nikland.txt"
IND = "countries/Inderia.txt"
BER = "countries/Berlend.txt"
EDD = "countries/Eddoran.txt"
LEV = "countries/Levy.txt"
RET = "countries/Retorry.txt"
ZER = "countries/Zerandy.txt"
AKV = "countries/Akvary.txt"
GLE = "countries/Glednar.txt"
SGO = "countries/Strogsky.txt"

MIR = "countries/Miranity.txt"
BOK = "countries/Boka.txt"
LOK = "countries/Loka.txt"
ATI = "countries/Atikiny.txt"
ZHI = "countries/Zhirstana.txt"
KTL = "countries/Karstla.txt"
BOV = "countries/Bovedo.txt"

NUR = "countries/Nuria.txt"
SHK = "countries/Shkadova.txt"
MCH = "countries/Micha-Loas.txt"
CSH = "countries/Chon-Shon.txt"
BRZ = "countries/Barzes.txt"
KBS = "countries/Kucht-Bosta.txt"
CTE = "countries/Cteven.txt"
BRT = "countries/Bartenian.txt"

TSH = "countries/Toshtaria.txt"
SKB = "countries/Skanbaria.txt"
KNL = "countries/Kerinkland.txt"

SKT = "countries/Sektoya.txt"
TUO = "countries/Tuorat.txt"
BKH = "countries/Barkhan.txt"
KPA = "countries/Karaten Praeter.txt"

FSF = "countries/Fersofia.txt"

HEK = "countries/Khekia.txt"
MLT = "countries/Terbia rebellians.txt"

BDA = "countries/BeldpoArmy.txt"
SUC = "countries/Comitet.txt"
NWA = "countries/NWAlliance.txt"
